.....#...
##.#.###.
...#.#...
.#.###.#.
.#.....#.
.#####.#.
...#.#...
##.#.#.##
.....#...